{
    "seed_money" : 10000,
    "waves": [
        {
            "key": "1",
            "values": [
                1, 1, 1, 1, 1, 1, 1, 1, 1, 1,
                1, 1, 1, 1, 1, 1, 1, 1, 1, 1,
                0, 0, 0, 0, 0, 0, 0, 0, 0, 0,
                1, 1, 1, 1, 1, 1, 1, 1, 1, 1,
                0, 0, 0, 0, 0, 0, 0, 0, 0, 0,
                0, 0, 0, 0, 0, 0, 0, 0, 0, 0,
                0, 0, 0, 0, 0, 0, 0, 0, 0, 0,
                0, 0, 0, 0, 0, 0, 0, 0, 0, 0,
                0, 0, 0, 0, 0, 0, 0, 0, 0, 0,
                1, 1, 1, 1, 1, 1, 1, 1, 1, 1
            ]
        },
                {
            "key": "2",
            "values": [
                0, 0, 0, 0, 0, 0, 0, 0, 0, 0,
                0, 0, 0, 0, 0, 0, 0, 0, 0, 0,
                0, 0, 0, 0, 0, 0, 0, 0, 0, 0,
                1, 1, 1, 1, 1, 1, 1, 1, 1, 1,
                0, 0, 0, 0, 0, 0, 0, 0, 0, 0,
                0, 0, 0, 0, 0, 0, 0, 0, 0, 0,
                0, 0, 0, 0, 0, 0, 0, 0, 0, 0,
                1, 1, 1, 1, 1, 1, 1, 1, 1, 1,
                0, 0, 0, 0, 0, 0, 0, 0, 0, 0,
                1, 1, 1, 1, 1, 1, 1, 1, 1, 1
            ]
        }

    ]
}
